1111111111111111111111111111111111
1000000000000000100000000000000001
10P00000000000001000000000C0000001
1000000000000000100000000000000001
10000C0000000000100000000000000001
1000000000000000100000000000000001
1000000000000000100000000000000001
1000000000000000100000000000000001
100000000C000000100000000000000001
1000000000000000100000000000000001
1000000000000000100000000000000001
1000000000000000100000000000000001
1000000000000000100C00000000000001
1000000000000000100000000000000001
1000000000000000100000000000000001
10000000000000001000000000000C0001
1000000000000000100000000000000001
1000000C00000000100000000000000E01
1000000000000000000000000000000011
1111111111111111111111111111111111