1111111111111
1PCCCE0CCC001
1111111111111